County,Year,SFunits,MFunits,TOTALunits,SF_Share,MF_Share,Source
Alameda County,1967,2810,2808,5618,0.5,0.5,CIRB
Contra Costa County,1967,3166,1643,4809,0.66,0.34,CIRB
Marin County,1967,800,302,1102,0.73,0.27,CIRB
Napa County,1967,537,251,788,0.68,0.32,CIRB
San Francisco County,1967,111,1159,1270,0.09,0.91,CIRB
San Mateo County,1967,1765,900,2665,0.66,0.34,CIRB
Santa Clara County,1967,7486,2755,10241,0.73,0.27,CIRB
Solano County,1967,903,816,1719,0.53,0.47,CIRB
Sonoma County,1967,1139,225,1364,0.84,0.16,CIRB
Alameda County,1968,4021,3871,7892,0.51,0.49,CIRB
Contra Costa County,1968,4166,1261,5427,0.77,0.23,CIRB
Marin County,1968,1000,497,1497,0.67,0.33,CIRB
Napa County,1968,618,202,820,0.75,0.25,CIRB
San Francisco County,1968,118,1228,1346,0.09,0.91,CIRB
San Mateo County,1968,1667,1692,3359,0.5,0.5,CIRB
Santa Clara County,1968,9398,8165,17563,0.54,0.46,CIRB
Solano County,1968,815,928,1743,0.47,0.53,CIRB
Sonoma County,1968,1466,367,1833,0.8,0.2,CIRB
Alameda County,1969,4027,4494,8521,0.47,0.53,CIRB
Contra Costa County,1969,2862,3485,6347,0.45,0.55,CIRB
Marin County,1969,933,699,1632,0.57,0.43,CIRB
Napa County,1969,501,229,730,0.69,0.31,CIRB
San Francisco County,1969,77,675,752,0.1,0.9,CIRB
San Mateo County,1969,1661,1438,3099,0.54,0.46,CIRB
Santa Clara County,1969,6812,11792,18604,0.37,0.63,CIRB
Solano County,1969,721,461,1182,0.61,0.39,CIRB
Sonoma County,1969,1571,804,2375,0.66,0.34,CIRB
Alameda County,1970,4758,5516,10274,0.46,0.54,CIRB
Contra Costa County,1970,2178,4558,6736,0.32,0.68,CIRB
Marin County,1970,834,470,1304,0.64,0.36,CIRB
Napa County,1970,487,426,913,0.53,0.47,CIRB
San Francisco County,1970,144,1627,1771,0.08,0.92,CIRB
San Mateo County,1970,1281,4268,5549,0.23,0.77,CIRB
Santa Clara County,1970,6316,11399,17715,0.36,0.64,CIRB
Solano County,1970,777,901,1678,0.46,0.54,CIRB
Sonoma County,1970,1716,1035,2751,0.62,0.38,CIRB
Alameda County,1971,7042,6274,13316,0.53,0.47,CIRB
Contra Costa County,1971,4852,6628,11480,0.42,0.58,CIRB
Marin County,1971,1644,1265,2909,0.57,0.43,CIRB
Napa County,1971,751,659,1410,0.53,0.47,CIRB
San Francisco County,1971,175,3439,3614,0.05,0.95,CIRB
San Mateo County,1971,2541,4602,7143,0.36,0.64,CIRB
Santa Clara County,1971,9302,10068,19370,0.48,0.52,CIRB
Solano County,1971,1658,1269,2927,0.57,0.43,CIRB
Sonoma County,1971,2877,1568,4445,0.65,0.35,CIRB
Alameda County,1972,4566,7191,11757,0.39,0.61,CIRB
Contra Costa County,1972,5687,3684,9371,0.61,0.39,CIRB
Marin County,1972,1371,2251,3622,0.38,0.62,CIRB
Napa County,1972,1006,169,1175,0.86,0.14,CIRB
San Francisco County,1972,169,3270,3439,0.05,0.95,CIRB
San Mateo County,1972,3025,5454,8479,0.36,0.64,CIRB
Santa Clara County,1972,9266,5630,14896,0.62,0.38,CIRB
Solano County,1972,2024,928,2952,0.69,0.31,CIRB
Sonoma County,1972,3264,2045,5309,0.61,0.39,CIRB
Alameda County,1973,3437,3657,7094,0.48,0.52,CIRB
Contra Costa County,1973,4723,2113,6836,0.69,0.31,CIRB
Marin County,1973,1235,2236,3471,0.36,0.64,CIRB
Napa County,1973,619,267,886,0.7,0.3,CIRB
San Francisco County,1973,286,3865,4151,0.07,0.93,CIRB
San Mateo County,1973,2109,4047,6156,0.34,0.66,CIRB
Santa Clara County,1973,7405,5449,12854,0.58,0.42,CIRB
Solano County,1973,2532,1000,3532,0.72,0.28,CIRB
Sonoma County,1973,2563,1433,3996,0.64,0.36,CIRB
Alameda County,1974,1788,1212,3000,0.6,0.4,CIRB
Contra Costa County,1974,3269,768,4037,0.81,0.19,CIRB
Marin County,1974,960,451,1411,0.68,0.32,CIRB
Napa County,1974,458,91,549,0.83,0.17,CIRB
San Francisco County,1974,223,1163,1386,0.16,0.84,CIRB
San Mateo County,1974,1566,600,2166,0.72,0.28,CIRB
Santa Clara County,1974,5823,3173,8996,0.65,0.35,CIRB
Solano County,1974,847,32,879,0.96,0.04,CIRB
Sonoma County,1974,2355,1337,3692,0.64,0.36,CIRB
Alameda County,1975,2655,817,3472,0.76,0.24,CIRB
Contra Costa County,1975,3797,517,4314,0.88,0.12,CIRB
Marin County,1975,759,389,1148,0.66,0.34,CIRB
Napa County,1975,504,162,666,0.76,0.24,CIRB
San Francisco County,1975,276,866,1142,0.24,0.76,CIRB
San Mateo County,1975,1323,609,1932,0.68,0.32,CIRB
Santa Clara County,1975,5700,2254,7954,0.72,0.28,CIRB
Solano County,1975,1972,495,2467,0.8,0.2,CIRB
Sonoma County,1975,2231,622,2853,0.78,0.22,CIRB
Alameda County,1976,2971,905,3876,0.77,0.23,CIRB
Contra Costa County,1976,6122,1026,7148,0.86,0.14,CIRB
Marin County,1976,857,388,1245,0.69,0.31,CIRB
Napa County,1976,546,252,798,0.68,0.32,CIRB
San Francisco County,1976,312,1310,1622,0.19,0.81,CIRB
San Mateo County,1976,1813,1072,2885,0.63,0.37,CIRB
Santa Clara County,1976,9318,3833,13151,0.71,0.29,CIRB
Solano County,1976,3032,142,3174,0.96,0.04,CIRB
Sonoma County,1976,3163,601,3764,0.84,0.16,CIRB
Alameda County,1977,3453,1257,4710,0.73,0.27,CIRB
Contra Costa County,1977,9059,1345,10404,0.87,0.13,CIRB
Marin County,1977,894,563,1457,0.61,0.39,CIRB
Napa County,1977,658,414,1072,0.61,0.39,CIRB
San Francisco County,1977,369,1167,1536,0.24,0.76,CIRB
San Mateo County,1977,2193,1646,3839,0.57,0.43,CIRB
Santa Clara County,1977,8446,4481,12927,0.65,0.35,CIRB
Solano County,1977,4707,711,5418,0.87,0.13,CIRB
Sonoma County,1977,3627,1245,4872,0.74,0.26,CIRB
Alameda County,1978,4054,2465,6519,0.62,0.38,CIRB
Contra Costa County,1978,4993,1415,6408,0.78,0.22,CIRB
Marin County,1978,1154,797,1951,0.59,0.41,CIRB
Napa County,1978,637,321,958,0.66,0.34,CIRB
San Francisco County,1978,227,1818,2045,0.11,0.89,CIRB
San Mateo County,1978,1185,1473,2658,0.45,0.55,CIRB
Santa Clara County,1978,7007,3492,10499,0.67,0.33,CIRB
Solano County,1978,3483,838,4321,0.81,0.19,CIRB
Sonoma County,1978,2565,996,3561,0.72,0.28,CIRB
Alameda County,1979,4129,2214,6343,0.65,0.35,CIRB
Contra Costa County,1979,5557,775,6332,0.88,0.12,CIRB
Marin County,1979,518,176,694,0.75,0.25,CIRB
Napa County,1979,337,35,372,0.91,0.09,CIRB
San Francisco County,1979,239,1594,1833,0.13,0.87,CIRB
San Mateo County,1979,1685,882,2567,0.66,0.34,CIRB
Santa Clara County,1979,6098,1938,8036,0.76,0.24,CIRB
Solano County,1979,2773,745,3518,0.79,0.21,CIRB
Sonoma County,1979,3069,999,4068,0.75,0.25,CIRB
Alameda County,1980,2743,2060,4803,0.57,0.43,CIRB
Contra Costa County,1980,4566,854,5420,0.84,0.16,CIRB
Marin County,1980,751,179,930,0.81,0.19,CIRB
Napa County,1980,320,116,436,0.73,0.27,CIRB
San Francisco County,1980,190,1012,1202,0.16,0.84,CIRB
San Mateo County,1980,1201,1106,2307,0.52,0.48,CIRB
Santa Clara County,1980,5071,2954,8025,0.63,0.37,CIRB
Solano County,1980,1724,554,2278,0.76,0.24,CIRB
Sonoma County,1980,1779,672,2451,0.73,0.27,CIRB
Alameda County,1981,2359,1530,3889,0.61,0.39,CIRB
Contra Costa County,1981,2523,585,3108,0.81,0.19,CIRB
Marin County,1981,302,234,536,0.56,0.44,CIRB
Napa County,1981,252,106,358,0.7,0.3,CIRB
San Francisco County,1981,83,1159,1242,0.07,0.93,CIRB
San Mateo County,1981,593,391,984,0.6,0.4,CIRB
Santa Clara County,1981,1997,1705,3702,0.54,0.46,CIRB
Solano County,1981,1102,211,1313,0.84,0.16,CIRB
Sonoma County,1981,1205,241,1446,0.83,0.17,CIRB
Alameda County,1982,1928,1884,3812,0.51,0.49,CIRB
Contra Costa County,1982,1769,1035,2804,0.63,0.37,CIRB
Marin County,1982,328,69,397,0.83,0.17,CIRB
Napa County,1982,249,307,556,0.45,0.55,CIRB
San Francisco County,1982,150,1065,1215,0.12,0.88,CIRB
San Mateo County,1982,324,568,892,0.36,0.64,CIRB
Santa Clara County,1982,1862,1080,2942,0.63,0.37,CIRB
Solano County,1982,966,477,1443,0.67,0.33,CIRB
Sonoma County,1982,1298,320,1618,0.8,0.2,CIRB
Alameda County,1983,3841,2072,5913,0.65,0.35,CIRB
Contra Costa County,1983,4684,2516,7200,0.65,0.35,CIRB
Marin County,1983,362,423,785,0.46,0.54,CIRB
Napa County,1983,530,316,846,0.63,0.37,CIRB
San Francisco County,1983,154,1058,1212,0.13,0.87,CIRB
San Mateo County,1983,680,428,1108,0.61,0.39,CIRB
Santa Clara County,1983,3255,3981,7236,0.45,0.55,CIRB
Solano County,1983,1631,678,2309,0.71,0.29,CIRB
Sonoma County,1983,2800,976,3776,0.74,0.26,CIRB
Alameda County,1984,3711,3794,7505,0.49,0.51,CIRB
Contra Costa County,1984,4170,2212,6382,0.65,0.35,CIRB
Marin County,1984,629,482,1111,0.57,0.43,CIRB
Napa County,1984,372,318,690,0.54,0.46,CIRB
San Francisco County,1984,409,904,1313,0.31,0.69,CIRB
San Mateo County,1984,816,1178,1994,0.41,0.59,CIRB
Santa Clara County,1984,3834,3490,7324,0.52,0.48,CIRB
Solano County,1984,1569,692,2261,0.69,0.31,CIRB
Sonoma County,1984,2957,2142,5099,0.58,0.42,CIRB
Alameda County,1985,3867,4228,8095,0.48,0.52,CIRB
Contra Costa County,1985,4673,4727,9400,0.5,0.5,CIRB
Marin County,1985,506,559,1065,0.48,0.52,CIRB
Napa County,1985,342,475,817,0.42,0.58,CIRB
San Francisco County,1985,173,1217,1390,0.12,0.88,CIRB
San Mateo County,1985,1270,872,2142,0.59,0.41,CIRB
Santa Clara County,1985,3809,5714,9523,0.4,0.6,CIRB
Solano County,1985,2169,3308,5477,0.4,0.6,CIRB
Sonoma County,1985,2930,3171,6101,0.48,0.52,CIRB
Alameda County,1986,4225,5722,9947,0.42,0.58,CIRB
Contra Costa County,1986,6295,6769,13064,0.48,0.52,CIRB
Marin County,1986,579,365,944,0.61,0.39,CIRB
Napa County,1986,469,138,607,0.77,0.23,CIRB
San Francisco County,1986,139,1898,2037,0.07,0.93,CIRB
San Mateo County,1986,1361,2144,3505,0.39,0.61,CIRB
Santa Clara County,1986,3235,4784,8019,0.4,0.6,CIRB
Solano County,1986,3519,1901,5420,0.65,0.35,CIRB
Sonoma County,1986,3282,593,3875,0.85,0.15,CIRB
Alameda County,1987,4489,4838,9327,0.48,0.52,CIRB
Contra Costa County,1987,5482,2950,8432,0.65,0.35,CIRB
Marin County,1987,888,471,1359,0.65,0.35,CIRB
Napa County,1987,518,9,527,0.98,0.02,CIRB
San Francisco County,1987,155,2287,2442,0.06,0.94,CIRB
San Mateo County,1987,1310,1708,3018,0.43,0.57,CIRB
Santa Clara County,1987,3078,4558,7636,0.4,0.6,CIRB
Solano County,1987,2949,406,3355,0.88,0.12,CIRB
Sonoma County,1987,2832,753,3585,0.79,0.21,CIRB
Alameda County,1988,3417,3135,6552,0.52,0.48,CIRB
Contra Costa County,1988,5876,2228,8104,0.73,0.27,CIRB
Marin County,1988,1004,382,1386,0.72,0.28,CIRB
Napa County,1988,859,115,974,0.88,0.12,CIRB
San Francisco County,1988,157,1774,1931,0.08,0.92,CIRB
San Mateo County,1988,1429,981,2410,0.59,0.41,CIRB
Santa Clara County,1988,3676,2789,6465,0.57,0.43,CIRB
Solano County,1988,4572,716,5288,0.86,0.14,CIRB
Sonoma County,1988,3857,818,4675,0.83,0.17,CIRB
Alameda County,1989,3067,2961,6028,0.51,0.49,CIRB
Contra Costa County,1989,5462,2208,7670,0.71,0.29,CIRB
Marin County,1989,884,530,1414,0.63,0.37,CIRB
Napa County,1989,884,82,966,0.92,0.08,CIRB
San Francisco County,1989,147,1361,1508,0.1,0.9,CIRB
San Mateo County,1989,1085,1335,2420,0.45,0.55,CIRB
Santa Clara County,1989,2548,2311,4859,0.52,0.48,CIRB
Solano County,1989,5400,833,6233,0.87,0.13,CIRB
Sonoma County,1989,3657,861,4518,0.81,0.19,CIRB
Alameda County,1990,1633,1365,2998,0.54,0.46,CIRB
Contra Costa County,1990,3132,1149,4281,0.73,0.27,CIRB
Marin County,1990,353,454,807,0.44,0.56,CIRB
Napa County,1990,652,55,707,0.92,0.08,CIRB
San Francisco County,1990,161,916,1077,0.15,0.85,CIRB
San Mateo County,1990,636,191,827,0.77,0.23,CIRB
Santa Clara County,1990,1675,3646,5321,0.31,0.69,CIRB
Solano County,1990,1763,551,2314,0.76,0.24,CIRB
Sonoma County,1990,2647,997,3644,0.73,0.27,CIRB
Alameda County,1991,1331,1299,2630,0.51,0.49,CIRB
Contra Costa County,1991,2684,1268,3952,0.68,0.32,CIRB
Marin County,1991,260,173,433,0.6,0.4,CIRB
Napa County,1991,419,337,756,0.55,0.45,CIRB
San Francisco County,1991,195,792,987,0.2,0.8,CIRB
San Mateo County,1991,503,331,834,0.6,0.4,CIRB
Santa Clara County,1991,1663,2102,3765,0.44,0.56,CIRB
Solano County,1991,1408,34,1442,0.98,0.02,CIRB
Sonoma County,1991,2048,160,2208,0.93,0.07,CIRB
Alameda County,1992,2337,741,3078,0.76,0.24,CIRB
Contra Costa County,1992,3279,620,3899,0.84,0.16,CIRB
Marin County,1992,259,43,302,0.86,0.14,CIRB
Napa County,1992,313,104,417,0.75,0.25,CIRB
San Francisco County,1992,70,559,629,0.11,0.89,CIRB
San Mateo County,1992,342,596,938,0.36,0.64,CIRB
Santa Clara County,1992,1693,1143,2836,0.6,0.4,CIRB
Solano County,1992,1609,194,1803,0.89,0.11,CIRB
Sonoma County,1992,1817,159,1976,0.92,0.08,CIRB
Alameda County,1993,2052,515,2567,0.8,0.2,CIRB
Contra Costa County,1993,3006,427,3433,0.88,0.12,CIRB
Marin County,1993,221,80,301,0.73,0.27,CIRB
Napa County,1993,291,124,415,0.7,0.3,CIRB
San Francisco County,1993,82,919,1001,0.08,0.92,CIRB
San Mateo County,1993,421,89,510,0.83,0.17,CIRB
Santa Clara County,1993,1822,1617,3439,0.53,0.47,CIRB
Solano County,1993,1419,50,1469,0.97,0.03,CIRB
Sonoma County,1993,1687,252,1939,0.87,0.13,CIRB
Alameda County,1994,2352,776,3128,0.75,0.25,CIRB
Contra Costa County,1994,3680,189,3869,0.95,0.05,CIRB
Marin County,1994,318,33,351,0.91,0.09,CIRB
Napa County,1994,382,12,394,0.97,0.03,CIRB
San Francisco County,1994,107,841,948,0.11,0.89,CIRB
San Mateo County,1994,599,301,900,0.67,0.33,CIRB
Santa Clara County,1994,2127,1827,3954,0.54,0.46,CIRB
Solano County,1994,1380,121,1501,0.92,0.08,CIRB
Sonoma County,1994,2117,334,2451,0.86,0.14,CIRB
Alameda County,1995,2492,458,2950,0.84,0.16,CIRB
Contra Costa County,1995,3047,307,3354,0.91,0.09,CIRB
Marin County,1995,337,241,578,0.58,0.42,CIRB
Napa County,1995,299,17,316,0.95,0.05,CIRB
San Francisco County,1995,106,409,515,0.21,0.79,CIRB
San Mateo County,1995,717,707,1424,0.5,0.5,CIRB
Santa Clara County,1995,2199,1285,3484,0.63,0.37,CIRB
Solano County,1995,946,169,1115,0.85,0.15,CIRB
Sonoma County,1995,1605,322,1927,0.83,0.17,CIRB
Alameda County,1996,3102,796,3898,0.8,0.2,CIRB
Contra Costa County,1996,3137,415,3552,0.88,0.12,CIRB
Marin County,1996,348,394,742,0.47,0.53,CIRB
Napa County,1996,228,4,232,0.98,0.02,CIRB
San Francisco County,1996,201,1277,1478,0.14,0.86,CIRB
San Mateo County,1996,673,432,1105,0.61,0.39,CIRB
Santa Clara County,1996,4042,3459,7501,0.54,0.46,CIRB
Solano County,1996,1180,557,1737,0.68,0.32,CIRB
Sonoma County,1996,1389,75,1464,0.95,0.05,CIRB
Alameda County,1997,4189,2311,6500,0.64,0.36,CIRB
Contra Costa County,1997,3093,421,3514,0.88,0.12,CIRB
Marin County,1997,420,178,598,0.7,0.3,CIRB
Napa County,1997,350,0,350,1,0,CIRB
San Francisco County,1997,210,1511,1721,0.12,0.88,CIRB
San Mateo County,1997,922,597,1519,0.61,0.39,CIRB
Santa Clara County,1997,4367,4443,8810,0.5,0.5,CIRB
Solano County,1997,1456,86,1542,0.94,0.06,CIRB
Sonoma County,1997,1783,338,2121,0.84,0.16,CIRB
Alameda County,1998,3774,2123,5897,0.64,0.36,CIRB
Contra Costa County,1998,3143,1106,4249,0.74,0.26,CIRB
Marin County,1998,604,109,713,0.85,0.15,CIRB
Napa County,1998,455,28,483,0.94,0.06,CIRB
San Francisco County,1998,184,2152,2336,0.08,0.92,CIRB
San Mateo County,1998,988,1187,2175,0.45,0.55,CIRB
Santa Clara County,1998,3911,3615,7526,0.52,0.48,CIRB
Solano County,1998,1768,436,2204,0.8,0.2,CIRB
Sonoma County,1998,1996,968,2964,0.67,0.33,CIRB
Alameda County,1999,3016,1495,4511,0.67,0.33,CIRB
Contra Costa County,1999,4081,508,4589,0.89,0.11,CIRB
Marin County,1999,699,37,736,0.95,0.05,CIRB
Napa County,1999,597,123,720,0.83,0.17,CIRB
San Francisco County,1999,114,3697,3811,0.03,0.97,CIRB
San Mateo County,1999,768,133,901,0.85,0.15,CIRB
Santa Clara County,1999,3333,3677,7010,0.48,0.52,CIRB
Solano County,1999,1430,523,1953,0.73,0.27,CIRB
Sonoma County,1999,2361,691,3052,0.77,0.23,CIRB
Alameda County,2000,2893,1315,4208,0.69,0.31,CIRB
Contra Costa County,2000,4344,1295,5639,0.77,0.23,CIRB
Marin County,2000,479,154,633,0.76,0.24,CIRB
Napa County,2000,531,4,535,0.99,0.01,CIRB
San Francisco County,2000,79,3286,3365,0.02,0.98,CIRB
San Mateo County,2000,846,1471,2317,0.37,0.63,CIRB
Santa Clara County,2000,2834,4220,7054,0.4,0.6,CIRB
Solano County,2000,2050,296,2346,0.87,0.13,CIRB
Sonoma County,2000,2034,521,2555,0.8,0.2,CIRB
Alameda County,2001,1613,1623,3236,0.5,0.5,CIRB
Contra Costa County,2001,4152,984,5136,0.81,0.19,CIRB
Marin County,2001,188,187,375,0.5,0.5,CIRB
Napa County,2001,773,134,907,0.85,0.15,CIRB
San Francisco County,2001,96,1723,1819,0.05,0.95,CIRB
San Mateo County,2001,722,719,1441,0.5,0.5,CIRB
Santa Clara County,2001,1641,4319,5960,0.28,0.72,CIRB
Solano County,2001,1821,739,2560,0.71,0.29,CIRB
Sonoma County,2001,1646,933,2579,0.64,0.36,CIRB
Alameda County,2002,2306,1266,3572,0.65,0.35,CIRB
Contra Costa County,2002,5076,729,5805,0.87,0.13,CIRB
Marin County,2002,288,152,440,0.65,0.35,CIRB
Napa County,2002,610,584,1194,0.51,0.49,CIRB
San Francisco County,2002,88,1242,1330,0.07,0.93,CIRB
San Mateo County,2002,653,770,1423,0.46,0.54,CIRB
Santa Clara County,2002,2057,2456,4513,0.46,0.54,CIRB
Solano County,2002,1791,670,2461,0.73,0.27,CIRB
Sonoma County,2002,1295,540,1835,0.71,0.29,CIRB
Alameda County,2003,2087,2433,4520,0.46,0.54,CIRB
Contra Costa County,2003,4965,1930,6895,0.72,0.28,CIRB
Marin County,2003,652,60,712,0.92,0.08,CIRB
Napa County,2003,593,56,649,0.91,0.09,CIRB
San Francisco County,2003,73,1509,1582,0.05,0.95,CIRB
San Mateo County,2003,735,569,1304,0.56,0.44,CIRB
Santa Clara County,2003,2320,5170,7490,0.31,0.69,CIRB
Solano County,2003,2134,544,2678,0.8,0.2,CIRB
Sonoma County,2003,1388,951,2339,0.59,0.41,CIRB
Alameda County,2004,2269,3422,5691,0.4,0.6,CIRB
Contra Costa County,2004,4222,1261,5483,0.77,0.23,CIRB
Marin County,2004,585,442,1027,0.57,0.43,CIRB
Napa County,2004,661,263,924,0.72,0.28,CIRB
San Francisco County,2004,65,2303,2368,0.03,0.97,CIRB
San Mateo County,2004,633,478,1111,0.57,0.43,CIRB
Santa Clara County,2004,2689,2816,5505,0.49,0.51,CIRB
Solano County,2004,2418,604,3022,0.8,0.2,CIRB
Sonoma County,2004,1343,598,1941,0.69,0.31,CIRB
Alameda County,2005,1518,2898,4416,0.34,0.66,CIRB
Contra Costa County,2005,5452,860,6312,0.86,0.14,CIRB
Marin County,2005,326,150,476,0.68,0.32,CIRB
Napa County,2005,533,120,653,0.82,0.18,CIRB
San Francisco County,2005,53,2671,2724,0.02,0.98,CIRB
San Mateo County,2005,427,465,892,0.48,0.52,CIRB
Santa Clara County,2005,2577,3295,5872,0.44,0.56,CIRB
Solano County,2005,2161,392,2553,0.85,0.15,CIRB
Sonoma County,2005,1639,1364,3003,0.55,0.45,CIRB
Alameda County,2006,1681,4035,5716,0.29,0.71,CIRB
Contra Costa County,2006,3310,1178,4488,0.74,0.26,CIRB
Marin County,2006,155,51,206,0.75,0.25,CIRB
Napa County,2006,263,240,503,0.52,0.48,CIRB
San Francisco County,2006,100,2892,2992,0.03,0.97,CIRB
San Mateo County,2006,445,492,937,0.47,0.53,CIRB
Santa Clara County,2006,2132,4072,6204,0.34,0.66,CIRB
Solano County,2006,1081,219,1300,0.83,0.17,CIRB
Sonoma County,2006,1361,601,1962,0.69,0.31,CIRB
Alameda County,2007,1340,1911,3251,0.41,0.59,CIRB
Contra Costa County,2007,2698,909,3607,0.75,0.25,CIRB
Marin County,2007,151,10,161,0.94,0.06,CIRB
Napa County,2007,262,52,314,0.83,0.17,CIRB
San Francisco County,2007,57,2791,2848,0.02,0.98,CIRB
San Mateo County,2007,658,367,1025,0.64,0.36,CIRB
Santa Clara County,2007,2063,2520,4583,0.45,0.55,CIRB
Solano County,2007,820,153,973,0.84,0.16,CIRB
Sonoma County,2007,904,622,1526,0.59,0.41,CIRB
Alameda County,2008,761,1296,2057,0.37,0.63,CIRB
Contra Costa County,2008,985,909,1894,0.52,0.48,CIRB
Marin County,2008,147,25,172,0.85,0.15,CIRB
Napa County,2008,215,32,247,0.87,0.13,CIRB
San Francisco County,2008,52,2395,2447,0.02,0.98,CIRB
San Mateo County,2008,312,630,942,0.33,0.67,CIRB
Santa Clara County,2008,1254,2417,3671,0.34,0.66,CIRB
Solano County,2008,323,239,562,0.57,0.43,CIRB
Sonoma County,2008,546,45,591,0.92,0.08,CIRB
Alameda County,2009,802,536,1338,0.6,0.4,CIRB
Contra Costa County,2009,1038,163,1201,0.86,0.14,CIRB
Marin County,2009,65,97,162,0.4,0.6,CIRB
Napa County,2009,126,6,132,0.95,0.05,CIRB
San Francisco County,2009,21,282,303,0.07,0.93,CIRB
San Mateo County,2009,236,393,629,0.38,0.62,CIRB
Santa Clara County,2009,667,450,1117,0.6,0.4,CIRB
Solano County,2009,559,0,559,1,0,CIRB
Sonoma County,2009,359,71,430,0.83,0.17,CIRB
Alameda County,2010,907,936,1843,0.49,0.51,CIRB
Contra Costa County,2010,809,890,1699,0.48,0.52,CIRB
Marin County,2010,75,0,75,1,0,CIRB
Napa County,2010,106,0,106,1,0,CIRB
San Francisco County,2010,25,749,774,0.03,0.97,CIRB
San Mateo County,2010,216,111,327,0.66,0.34,CIRB
Santa Clara County,2010,826,3627,4453,0.19,0.81,CIRB
Solano County,2010,441,0,441,1,0,CIRB
Sonoma County,2010,280,190,470,0.6,0.4,CIRB
Alameda County,2011,817,1352,2169,0.38,0.62,CHF
Contra Costa County,2011,718,355,1073,0.67,0.33,CHF
Marin County,2011,55,61,116,0.47,0.53,CHF
Napa County,2011,128,26,154,0.83,0.17,CHF
San Francisco County,2011,30,1972,2002,0.01,0.99,CHF
San Mateo County,2011,213,545,758,0.28,0.72,CHF
Santa Clara County,2011,978,2234,3212,0.3,0.7,CHF
Solano County,2011,392,0,392,1,0,CHF
Sonoma County,2011,443,184,627,0.71,0.29,CHF
Alameda County,2012,1119,1508,2627,0.43,0.57,CHF
Contra Costa County,2012,1188,949,2137,0.56,0.44,CHF
Marin County,2012,67,50,117,0.57,0.43,CHF
Napa County,2012,133,20,153,0.87,0.13,CHF
San Francisco County,2012,30,3145,3175,0.01,0.99,CHF
San Mateo County,2012,264,671,935,0.28,0.72,CHF
Santa Clara County,2012,1432,4245,5677,0.25,0.75,CHF
Solano County,2012,470,59,529,0.89,0.11,CHF
Sonoma County,2012,279,318,597,0.47,0.53,CHF
Alameda County,2013,1339,2023,3362,0.4,0.6,CHF
Contra Costa County,2013,1585,370,1955,0.81,0.19,CHF
Marin County,2013,90,212,302,0.3,0.7,CHF
Napa County,2013,97,140,237,0.41,0.59,CHF
San Francisco County,2013,69,5208,5277,0.01,0.99,CHF
San Mateo County,2013,350,840,1190,0.29,0.71,CHF
Santa Clara County,2013,1859,6009,7868,0.24,0.76,CHF
Solano County,2013,524,281,805,0.65,0.35,CHF
Sonoma County,2013,295,732,1027,0.29,0.71,CHF
Alameda County,2014,1076,2048,3124,0.34,0.66,CHF
Contra Costa County,2014,1439,588,2027,0.71,0.29,CHF
Marin County,2014,112,76,188,0.6,0.4,CHF
Napa County,2014,103,49,152,0.68,0.32,CHF
San Francisco County,2014,35,3035,3070,0.01,0.99,CHF
San Mateo County,2014,315,1302,1617,0.19,0.81,CHF
Santa Clara County,2014,1602,8310,9912,0.16,0.84,CHF
Solano County,2014,655,0,655,1,0,CHF
Sonoma County,2014,292,214,506,0.58,0.42,CHF
Alameda County,2015,1724,3307,5031,0.34,0.66,CHF
Contra Costa County,2015,1874,556,2430,0.77,0.23,CHF
Marin County,2015,119,20,139,0.86,0.14,CHF
Napa County,2015,141,148,289,0.49,0.51,CHF
San Francisco County,2015,66,3604,3670,0.02,0.98,CHF
San Mateo County,2015,424,1097,1521,0.28,0.72,CHF
Santa Clara County,2015,1613,3283,4896,0.33,0.67,CHF
Solano County,2015,1037,331,1368,0.76,0.24,CHF
Sonoma County,2015,235,206,441,0.53,0.47,CHF
